537 739
xx........
..x.......
...xx.....
.....x....
......x...
......x...
.......x..
.......xxx
.........x
.........x
537
