569 445
x.........
x.........
x.........
xxxx......
....x.....
.....x....
......x...
......x...
......x...
......x...
......x...
.......x..
........x.
........x.
.........x
445
