1045 1032
xxxxxxxxxxxxxxxxx...
.................x..
.................x..
.................x..
..................x.
..................x.
..................x.
..................x.
...................x
...................x
1032
